//MAP CONVERTED BY dmm2tgm.py THIS HEADER COMMENT PREVENTS RECONVERSION, DO NOT REMOVE
"a" = (
/turf/closed/wall/mineral/titanium,
/area/shuttle/labor)
"c" = (
/obj/structure/shuttle/engine/propulsion,
/turf/open/floor/plating,
/area/shuttle/labor)
"d" = (
/obj/structure/table,
/turf/open/floor/mineral/plastitanium,
/area/shuttle/labor)
"i" = (
/obj/structure/rack,
/turf/open/floor/mineral/plastitanium/red/brig,
/area/shuttle/labor)
"k" = (
/obj/effect/spawner/structure/window/shuttle,
/turf/open/floor/plating,
/area/shuttle/labor)
"r" = (
/obj/machinery/door/window/brigdoor{
	dir = 1;
	name = "Perma Prisoners";
	pixel_y = 2;
	req_access_txt = "2"
	},
/turf/open/floor/mineral/plastitanium/red/brig,
/area/shuttle/labor)
"s" = (
/obj/structure/chair/office{
	dir = 1
	},
/turf/open/floor/mineral/plastitanium,
/area/shuttle/labor)
"u" = (
/obj/machinery/computer/shuttle/perma{
	dir = 8
	},
/turf/open/floor/mineral/plastitanium,
/area/shuttle/labor)
"z" = (
/obj/structure/chair/comfy/shuttle{
	dir = 4
	},
/turf/open/floor/mineral/plastitanium/red/brig,
/area/shuttle/labor)
"A" = (
/obj/structure/shuttle/engine/propulsion/burst/left,
/turf/open/floor/plating,
/area/shuttle/labor)
"F" = (
/obj/structure/window/reinforced{
	pixel_y = -5
	},
/turf/open/floor/mineral/plastitanium,
/area/shuttle/labor)
"I" = (
/obj/structure/shuttle/engine/propulsion/burst/right,
/turf/open/floor/plating,
/area/shuttle/labor)
"N" = (
/obj/structure/closet/crate,
/turf/open/floor/mineral/plastitanium/red/brig,
/area/shuttle/labor)
"P" = (
/obj/structure/shuttle/engine/heater,
/obj/structure/window/reinforced{
	dir = 1
	},
/turf/open/floor/plating,
/area/shuttle/labor)
"Q" = (
/obj/structure/chair/comfy/shuttle{
	dir = 8
	},
/turf/open/floor/mineral/plastitanium/red/brig,
/area/shuttle/labor)
"T" = (
/obj/machinery/door/airlock/titanium{
	name = "Labor Shuttle Airlock";
	req_access_txt = "2"
	},
/obj/docking_port/mobile{
	dheight = 5;
	dir = 8;
	dwidth = 4;
	height = 8;
	id = "permashuttle";
	name = "Perma Shuttle";
	width = 5
	},
/turf/open/floor/mineral/plastitanium,
/area/shuttle/labor)
"X" = (
/turf/open/floor/mineral/plastitanium/red/brig,
/area/shuttle/labor)
"Y" = (
/turf/open/floor/mineral/plastitanium,
/area/shuttle/labor)

(1,1,1) = {"
a
a
a
a
k
a
a
a
"}
(2,1,1) = {"
k
d
F
z
i
z
P
A
"}
(3,1,1) = {"
k
s
Y
r
X
X
P
c
"}
(4,1,1) = {"
k
u
F
Q
N
Q
P
I
"}
(5,1,1) = {"
a
a
T
a
k
a
a
a
"}
